subvert	A
jerk	A 
hedge	F?
attract	S
sexual	S
orgasm	S
refuse	A
reject	A
hate	A
hat	A
torture	A
tortur	A
yell	A
taunt	A
scream	A
hug	F
deface	A
follow	A
nibble	A
belay	F?
#throw	A?
startle	A
trace	A?
tickle	S
flail	A S?
tack	A?
hood	A
roughen	A
dislodge	A
tap	A
rape	A S
eviscerate	A
blindfold	A S?
squelch	A
smack	S
steal	A
bolster	F
mangle	A
flip	A
bind	A S
bisect	A
press	A
fleece	A
toe	A
ax	A
disjoint	A
eject	A
propel	A
unseat	A
cudgel	A
shell	A
conk	A
restrain	A
flick	A S?
knot	S?
lift	A
depress	A
bend	A S
sling	A
bandage	A S?
foul	A
semi-embrace	F
embrace	F
rebind	A
hack	A
lance	A
belabor	A
safe	F
smear	A?
tip	A
borrow	F
clout	A
scuffle	A
chop	A
trisect	A
stick	A
shred	A
bloc	A
choke	A
tail	A?
heave	A
dropkick	A
punt	A
belabour	A
squash	A
toy	S
bump	A
bop	A
boot	A
bludgeon	A
massage	S
club	A
rifle	A
bury	A
whack	A
girdle	S
love	S F
#go	F
string	A
bombard	A
nobble	A
lick	S?
spur	F
unsaddle	A
brandish	A
ram	A
knock	A
spatter	A
pluck	A
pare	A
mince	A
lapidate	A
stretch	A
kiss	S F
mow	A
frogmarch	A
ensnare	A
poke	A
drown	A
rip	A
whipsaw	A
grease	S
brand	A
seize	A
love-making	S
stroke	S
naked	S
excite	S
scythe	A
claw	A
seal	A
#ride	S
divaricate	?
#tongue	S
punch	A
flagellate	A
trepan	A
hitch	A
copulate	S
slit	A
fire	A
hurt	A
hurl	A
#give	?
stone	A
undress	S
bolt	A
run	A
flood	A
bean	A
pitchfork	A
scratch	A S?
cast	A
pound	A
mulch	A
#finger	S
nestle	S
break	A
scotch	A
jettison	A
lug	A
tackle	A
discerp	A
stun	A
gag	A
hunt	A
turf	A
tear	A
liquidate	A
kick	A
violate	A
snog	S
hi	F
marriage	F
wedding	F
laughingly	F
laugh	F
laughing	F
rescue	F
teach	F
wed	F
wedd	F
save	F
protect	F
marry	F
thank	F
#want	F
enjoy	F
hello	F
smile	F
apologize	F
gift	F
care	F
assist	F
agree	F
greet	F
goodbye	F
bye	F
interest	S
advise	F
attract	S F
like	S F
cosh	A
seduce	S
spank	A S
prod	A
frazzle	A?
caress	F S?
trap	A
poniard	A
rope	A
skin	A
deflower	A
#bed	S
tree	A
sex	S
#upset	A
mark	A
snarl	A
fret	A
execute	A
kidnap	A
block	A
hook	A?
spat	A
exclude	A?
clench	F?
screw	S
compress	A?
bite	A
strangulate	A
curb	A?
pumice	S
constrict	A?
shear	S?
obstruct	A?
#pair	S
haul	A
vex	A?
commandeer	A?
nab	A
cheese	A?
swipe	A
plunder	A
hammer	A
nick	A
stifle	A
abduct	A
muddy	A?
wind	?
amputate	A
welcome	F
mortar	A
whisk	A?
dirty	A
separate	A?
sacrifice	A
die	A
pinion	A
crock	A
#feel	?
hang	A
fight	A
collide	A
tease	A
clobber	A
lacerate	A
fornicate	S
unclothe	A S
explode	A
dissect	A
whittle	A?
brain	A
sledgehammer	A
transfix	A
corral	A
headbutt	A
pummel	A
smite	A
wrench	A
apprehend	A?
cord	A
pierce	A
#ball	S
lash	A
deflate	A
inject	A?
kill	A
rend	A
rut	S
pursue	A
zap	A
dismember	A
suggest	F
rack	A
paw	S?
snaffle	A?
smooch	S
vivisect	A
whip	A
canoodle	S
overwhelm	A
entangle	A
smash	A
uproot	A
swat	A
prick	A
jab	A
butcher	A
capture	A
wield	A?
#keep	?
crush	A
undo	A
doff	S
#make	?
chase	A
sting	A
mesh	A
destroy	A
#have	?
incite	F
point	A?
fractionate	A
confine	A
pull	A?
axe	A
slap	A
strike	A
shoot	A
collar	A
clash	A
piggyback	F
embrace	F
strangle	A
muzzle	A
touch	?
twiddle	F
bang	S
cut	A
deplume	A
bare	S
squirt	A
peck	F
overbear	A
exterminate	A
#take	?
gut	A
insist	A
rail	A
suck	S
interrupt	A
sock	A
twist	A
spear	A
shock	A
hit	A
hijack	A
cradle	F
strip	S
launch	?
foray	A
nudge	A
#worry	F
bruise	A
poison	A
shove	A
nip	S
leather	A
backhand	A
spit	A
sideswipe	A
ruin	A
maul	A
pet	F S
down	A
recapture	A
noose	A
birch	A
wrestle	A
chuck	A?
thump	A
chew	A
goad	F
batfowl	A
bark	A?
palpate	S
expropriate	A?
trim	A?
spar	A?
tomahawk	A
cane	A
scourge	A
flush	S F?
cohere	F
#receive	?
clinch	A?
flay	A
flog	A
lie	A
thrash	A
rebate	F
fetch	A?
dash	A
evict	A
pinch	A F?
drag	A
slash	A
beat	A
fix	F
play	F
sabre	A
bust	A
catch	A
#get	?
tether	A
knife	A
yank	A
spoon	S
lubricate	S
impede	A
scar	A
raid	A
masturbate	A S
lasso	A
bayonet	A
trademark	A
buffet	A
stab	A
band	F
heckle	A
gore	A
#put	?
snatch	A
argue	A
cuff	A
lock	A?
manacle	A
struggle	A
decapitate	A
#close	A?
stop	A
recover	F
circumcise	A
nail	A
segregate	A
stripe	S
wallop	A
thrust	A
#storm	A
untie	F
martyr	A
immobilize	A
invade	A
cuddle	F
dick	S
horsewhip	A
belt	A
support	F
fling	A
bastinado	A
pelt	A
beset	A
fell	A
unburden	F
penetrate	S
enchain	A
unwind	F
gird	A
push	A
flirt	S
cunt	S
submerge	A
anatomize	A
smother	A
impale	A
vagina	S
penis	S
butt	S
blast	A
away	A
#hold	A?
manipulate	A
swaddle	F
suffocate	A
defenestrate	A
chain	A
stoop	F
#neck	S
manhandle	A
wrest	A
parallelize	A
chisel	A
welt	A
force	A
help	F
trade	A?